곡성 : 곽도원,황정민,쿠니무라 준,천우희,김환희,허진,장소연,김도윤,손강국,전배수,황석정,배용근,배용근,이인철,이용녀,선호삼,송민석,신재현,안수연,이선희,이수빈,이수진,권귀덕,이연,이연경,이연경,백승철,이정은
살인자의 기억법 : 설경구,김남길,설현,오달수,이현명,장정윤,전동성,전동성,전동성,전승표,백연정,백연정,정동석,정동석,유지현,윤선용,추동우,함연주,이종건,박상욱,박상운,전승표,김정영
가디언즈 오브 갤럭시 VOL. 2 : 크리스 프랫,조 샐다나,데이브 바티스타,빈 디젤,브래들리 쿠퍼
미녀와 야수 : 페이지 오하라,로비 벤슨
택시운전사 : 이수민,송강호,토마스 크레취만,유해진,류준열,박혁권,최귀화,이창섭,이호균,서정우,송병철,안용우,오석규,윤석진,이새별,이성호,이정은,이주영,황민형,김신웅,김진상,김화목,문광식,차순배,김대현,서현우
뷰티 인사이드 : 한효주,김대명,도지한,배성우,박신혜,이범수,박서준,김상호,천우희,우에노 주리,이재준,김민재,이현우,조달환,이진욱,홍다미,서강준,김희원,이동욱,고아성,김주혁,유연석,이동휘,문숙,이경영,최용민,이미도,신동미,김시은,유재상,오상철,임예진,정두원,박지현,정은교,조유덕,차수보,차정환,손영진,신예진,유보라,윤여진,이미애,홍승철,이성준,이소연,이슬기,이승대,이진성,공민정,고규필,이봄
매드 맥스: 분노의 도로 : 톰 하디,샤를리즈 테론,니콜라스 홀트,조 크라비츠,로지 헌팅턴-휘틀리,라일리 코프,메간 게일,애비 리,코트니 이튼
엑스맨: 아포칼립스 : 제임스 맥어보이,마이클 패스벤더,제니퍼 로렌스,오스카 아이삭,니콜라스 홀트,로즈 번,타이 쉐리던,소피 터너,올리비아 문,루카스 틸
꾼 : 현빈,유지태,배성우,박성웅,나나,안세하,최덕문,전보람,전헌태,유정호,이용희,이재남,이창호,김동철,황인범,김태강,차순배
배트맨 대 슈퍼맨: 저스티스의 시작 : 헨리 카빌,벤 애플렉,에이미 아담스,로렌스 피쉬번,제시 아이젠버그,제레미 아이언스,홀리 헌터,갤 가돗
앤트맨 : 폴 러드,마이클 더글라스,에반젤린 릴리,코리 스톨
미니언즈 : 산드라 블록,존 햄,마이클 키튼
강철비 : 정우성,곽도원,김갑수,김의성,이경영,조우진,정원중,김명곤,박은혜,김지호,안미나,원진아,정유나,이상민,이정호,정환,한승헌,박민희
보안관 : 이성민,조진웅,김성균,김종수,조우진,임현성,배정남,염진환,박윤호,박지훈,신지훈,이규섭,이동현,최형욱,이윤희,이정은,손여은
미스 페레그린과 이상한 아이들의 집 : 에바 그린,사무엘 L. 잭슨,아사 버터필드,앨리슨 제니,킴 디킨스,주디 덴치,크리스 오다우드
아이 캔 스피크 : 나문희,이제훈,박철민,염혜란,성유빈,김소진,이상희,정연주,이지훈,손숙,박준서,이승민,이정현,홍상원,황연희,이재인,우지현
아가씨 : 김민희,김태리,하정우,조진웅,김해숙,문소리,최병모,김인우,이용녀,조은형,장한순,이규정,이승준,이윤재,김시은
악의 연대기 : 손현주,마동석,최다니엘,박서준,이준혁,이태호,이현우,강민정,조은수,서정우,최동헌,안용우,이명준,이성재,이용희,이은정,김태강,정원중,지대한,장준녕,정준원
캐리비안의 해적: 죽은 자는 말이 없다 : 조니 뎁,카야 스코델라리오,올랜도 블룸,하비에르 바르뎀,브렌튼 스웨이츠,제프리 러쉬,데이빗 웬햄,골시프테 파라하니,스티븐 그레이엄,케빈 맥널리,폴 매카트니,마틴 클레바,로드니 아피프
베테랑 : 황정민,유아인,유해진,오달수,장윤주,김시후,오대환,정웅인,정만식,송영창,진경,유인영,박소담,이동휘,배성우,천호진,이채은,조덕현,신지수,권지훈,정윤헌,장한승,김선웅,김성종,우영택,김민재,김재현,김태용,김지수,박지윤,박지혜,손성민,장소연,유재명,배제기,류아벨,정재헌,안길강,마동석,김응수,고규필,서현우
주토피아 : 지니퍼 굿윈,제이슨 베이트먼,샤키라
부산행 : 공유,김정희,정유미,김율호,마동석,최우식,안소희,김의성,김수안,박민우,박민혁,임종훈,박종관,장문성,박혜진,손지훈,손지훈,연상호,조춘호,지동현,윤미중,이동하,이윤상,최창수,편준의,허성우,황유경,최용훈,김근영,이주실,예수정,김대현,한지은
미녀와 야수 : 엠마 왓슨,댄 스티븐스,루크 에반스,이완 맥그리거,이안 맥켈런,엠마 톰슨,구구 바샤-로,케빈 클라인,스탠리 투치
킹스맨 : 시크릿 에이전트 : 콜린 퍼스,태런 에저튼,사무엘 L. 잭슨,마이클 케인
마스터 : 이병헌,강동원,김우빈,엄지원,오달수,박해수,진경,김정우,장한별,이승용,김대현,홍성덕
연평해전 : 김무열,진구,김율호,이현우,이완,이청아,천민희,이한종,박찬희,박혜준,최순조,최승준,최종환,송재호,유형균,박정학,이철민,김강일,김희정
빅 히어로 : 라이언 포터,스콧 애짓,다니엘 헤니,제이미 정,T.J. 밀러,제네시스 로드리게스,데이몬 웨이언스 주니어,마야 루돌프,제임스 크롬웰,알란 터딕
인천상륙작전 : 김정철,이정재,이범수,리암 니슨,진세연,정준호,박철민,김병옥,김선아,김영애,박성웅,추성훈,황석하,이창세,박정원,박현선,션 리차드,이유진,한비,김희진,진용욱
히말라야 : 황정민,정우,조성하,김인권,라미란,김원해,이해영,전배수,정유미,유선,한명환,김재준,박민우,배상민,이춘우,이혜진,최종률,조달환
군함도 : 황정민,김규백,명인호,소지섭,송중기,이정현,김수안,지웅배,손용범,박상호,박선,박선주,박영준,박정민,박준서,박준서,박혜민,성정훈,오정현,오형근,전창현,정규호,정부용,지재우,이다영,이동준,이상협,이선민,이세형,이윤2,최호영,이재민,이정민,이정은,이정현,이제훈,허승준,이준희,이지은,이지환,이태영,이하은,이하준,이경영,장성범,백승철,김준한,김고은,박성일,설준수,조경현,여윤호,이준혁
스타워즈: 깨어난 포스 : 해리슨 포드,마크 해밀,캐리 피셔,사이먼 페그,오스카 아이삭,막스 본 시도우,도널 글리슨
스파이더맨: 홈 커밍 : 제이콥 배덜런,톰 홀랜드,로버트 다우니 주니어,마이클 키튼,마리사 토메이,젠다야 콜맨,존 파브로,마틴 스타,로건 마샬-그린,가르셀라 보베,스탠 리,보킴 우드바인,케네스 최,토니 레볼로리,타인 달리
귀향 : 손숙,강하나,서미지,최리,정인기,오지혜,김시은,이채현,임성철,임혜영,박주현,박지희,박진경,장현익,정광윤,정부경,정승현,안재성,이경훈,이민영,이선희,이수현,이승현,이여원,김완기,김은나,정무지,류신
마션 : 맷 데이먼,제시카 차스테인,제프 다니엘스,케이트 마라,크리스틴 위그
정글북 : 닐 세티,빌 머레이,스칼렛 요한슨,벤 킹슬리,이드리스 엘바,루피타 뇽오,크리스토퍼 월켄,지안카를로 에스포지토
레버넌트: 죽음에서 돌아온 자 : 레오나르도 디카프리오,톰 하디
데드풀 : 라이언 레놀즈,모레나 바카린,에드 스크레인,지나 카라노,T.J. 밀러,브리아나 힐데브란드
분노의 질주: 더 익스트림 : 빈 디젤,드웨인 존슨,샤를리즈 테론,제이슨 스타뎀,스콧 이스트우드,커트 러셀,미셸 로드리게즈,엘자 패터키,에바 멘데스,헬렌 미렌,조다나 브루스터,루카스 블랙,타이레스 깁슨,루다크리스
제이슨 본 : 맷 데이먼,줄리아 스타일즈,토미 리 존스,뱅상 카셀,알리시아 비칸데르
암살 : 전지현,이정재,하정우,오달수,조진웅,이경영,최덕문,김의성,박병은,김홍파,강용빈,홍성지,지동주,장현석,장용현,김민지,김승찬,안태랑,김예은,김정석,김정호,김준우,김지원,박상민,박정환,조승우,김해숙,진경,박소은,김인우,심희섭,김태준,차지원
남한산성 : 이병헌,김윤석,박해일,고수,박희순,조우진,박주운,박지원,백동현,서병철,장정국,이정호,이호중,권효민
로건 : 휴 잭맨,패트릭 스튜어트,보이드 홀브룩,스테판 머천트,리차드 E. 그랜트,에릭 라 살,엘리스 닐
스파이 : 주드 로,제이슨 스타뎀,멜리사 맥카시
쥬라기 월드 : 크리스 프랫,주디 그리어,브라이스 달라스 하워드,케이티 맥그라스,제이크 존슨,빈센트 도노프리오
터미네이터 제니시스 : 아놀드 슈왈제네거,제이슨 클락,에밀리아 클라크,제이 코트니,J.K. 시몬스,다요 오케니이,맷 스미스,코트니 B. 반스,이병헌,아론 V. 윌리엄슨
검사외전 : 황정민,강동원,이성민,박성웅,김응수,신소율,주진모,김원해,김홍파,김병옥,박종환,전배수,박지환,손종학,신혜선,김시은,김종수,한재영,박지환,박종우,박지홍,송승현,윤석민,이규호,이석준,이선주,이승민,이승우,이승준,이승훈,이승훈,최현준,김영,이정은
미션 임파서블: 로그네이션 : 톰 크루즈,제레미 레너,사이먼 페그,알렉 볼드윈,레베카 퍼거슨
1987 : 김윤석,하정우,유해진,김태리,박희순,이희준,설경구,여진구,유정호,윤재국,지웅배,정재윤,이가영,이동욱,이동희,이상준,이태형,최광일,강동원,문소리,문성근,김원진,남민우,이주영,임병우,김시은,김기태,정재윤,황성준,서현우,조민준
메이즈 러너: 스코치 트라이얼 : 딜런 오브라이언,토마스 생스터,카야 스코델라리오,이기홍
닥터 스트레인지 : 베네딕트 컴버배치,레이첼 맥아담스,틸다 스윈튼,매즈 미켈슨,치웨텔 에지오포,스콧 앳킨스,마이클 스털버그,베네딕트 왕
굿바이 싱글 : 김혜수,마동석,김현수,김용건,서현진,곽시양,전석호,이미도,이성민,황미영,이형미,박지영,정준화,유성진,윤환,이수경,최문석,홍민희,김근영,안재홍,황승언,김고은,목규리,이선빈
혹성탈출: 종의 전쟁 : 앤디 서키스,우디 해럴슨,스티브 잔,주디 그리어,타이 올슨,채드 룩,티모시 웨버,마이클 아담스웨이트,라우로 차트랜드,스티브 바란칙
럭키 : 유해진,이준,조윤희,임지연,전혜빈,이동휘,박선용,박은미,정소리,이승철,최시형,홍의권,문광식,김기정,고준,차엽
캡틴 아메리카: 시빌 워 : 크리스 에반스,로버트 다우니 주니어,스칼렛 요한슨,세바스찬 스탠,안소니 마키,돈 치들,제레미 레너,톰 홀랜드
터널 : 하정우,배두나,오달수,김종수,임한빈,정민희,송민석,윤성민,이동진,이상희,최춘범,권승구,진용욱,이한서,예수정,서현우
박열 : 이제훈,최희서,김인우,권율,민진웅,이형석,박진성,배정환,서동기,정무진,정승채,조박,윤재국,이경수,이동욱,이병훈,이성규,이승환,이신우,이영상,이재성,이정현,이종민,홍준석,달시 파켓,김준한,최정헌,백수장
청년경찰 : 김규백,박서준,정다은,강하늘,성동일,박하선,이하준,이현일,임대현,박재홍,박정훈,장석진,서은지,서정우,서지원,신정화,조윤주,우상기,이강재,이다영,최광원,최지민,이도현,이상민,이세희,이수진,한재욱,이승희,이은비,이재웅,이정수,이주원,서정연,고준,전준영
스물 : 김우빈,이준호,강하늘,정덕희,주창욱,권지훈,오하늬,오현경,이성두,정소민,안재홍,이유비,김의성,김종수,민지,황미영,서호철
너의 이름은. : 카미키 류노스케,카미시라이시 모네,나가사와 마사미,이치하라 에수코,유키 아오이,시마자키 노부나가,이시카와 카이토,타니 카논
형 : 조정석,도경수,박신혜,권지훈,김승아,김진희,이연수,강두,정지훈
극비수사 : 김윤석,유해진,송영창,장영남,정호빈,이준혁,이종일,장성훈,정규용,정기용,백승호,이효제,최원,송승현,신유경,양중경,유주영,홍명기,이석현,이소영,이승준,이윤희,이인규,주영호,박효주,이재용,남문철,황성준,조민준
미이라 : 톰 크루즈,소피아 부텔라,애나벨 월리스,러셀 크로우,하비에르 보텟,제이크 존슨,코트니 B. 반스,딜란 스미스
원더 우먼 : 갤 가돗,로빈 라이트,크리스 파인,데이빗 듈리스,코니 닐슨,엘레나 아나야
재심 : 정우,강하늘,김해숙,이동휘,한재영,이경영,박희정,우상기,조해진,유지현,이다은,이동희,이동준,이승훈,한하늘,이정수,이정은,이종재,김진욱,김소진,김하나,최정헌
도리를 찾아서 : 엘렌 드제너스,알버트 브룩스,다이안 키튼
강남 1970 : 이민호,김래원,정진영,설현,유승목,한재영,이연두,정호빈,최진호,엄효섭,최병모,지대한,전배수,윤종화,서우진,이인혁,이정완,이주협,박소희,박시연,이한울,임성숙,장준혁,전우재,강풍,박재영,박재희,박준영,정영택,백동현,정창용,조선기,서현석,천영암,손재영,주연서,신영규,양진석,오형근,유정호,윤지원,이규석,김원진,이성용,이성준,이세훈,황재진,이원희,이은주,안정우,정진영,김지수,곽민호,이가경
마이펫의 이중생활 : 스티브 쿠건,엘리 켐퍼,레이크 벨,데이너 카비,케빈 하트
쿵푸팬더3 : 잭 블랙,안젤리나 졸리,더스틴 호프만,성룡,세스 로건,루시 리우,데이빗 크로스,J.K. 시몬스
인사이드 아웃 : 다이안 레인,에이미 포엘러,카일 맥라클란,민디 캘링,빌 헤이더
공조 : 현빈,유해진,김주혁,장영남,이해영,윤아,이동휘,박형수,서은지,신유철,이재남,공정환,김준한,신문성
트랜스포머: 최후의 기사 : 마크 월버그,안소니 홉킨스,로라 하드독,조쉬 더하멜
나우 유 씨 미 2 : 제시 아이젠버그,마크 러팔로,우디 해럴슨,데이브 프랑코,다니엘 래드클리프,리지 캐플란,주걸륜,마이클 케인,모건 프리먼
판도라 : 김남길,김영애,문정희,정진영,이경영,강신일,김대명,유승목,김주현,김명민,김동우,김선형,김승배,김영준,김재민,김정훈,김태영,김태현,김태훈,박기태,박선희,박준영,이경재,최우성,공정환
토르: 라그나로크 : 크리스 헴스워스,톰 히들스턴,케이트 블란쳇,이드리스 엘바,제프 골드블럼,테사 톰슨,칼 어번,마크 러팔로,안소니 홉킨스
범죄도시 : 마동석,윤계상,조재윤,최귀화,박상규,유지연,최성재,이경원,이태규,진선규,허동원
아수라 : 정우성,김현빈,황정민,주지훈,곽도원,정만식,김원해,김종수,김해곤,윤지혜,오연아,윤제문,이종성,장근영,박지환,손영진,양영일,유정호,윤성민,이가경,이광기,이상민,채성원,김남조,노남석,박갑진
사도 : 송강호,유아인,문근영,전혜진,김해숙,박원상,진지희,박소담,서예지,이효제,곽동호,최희영,정호,이현철,김상훈,이민혜,김경원,김대환,김민규,양지혜,안현숙,김우진,이대연,최덕문,정석용,최민철,안정우,안태훈,조승연,차순배
프리즌 : 한석규,김래원,정웅인,조재윤,신성록,곽민호,박영준,임경욱,장한승,신영진,지동주,유정호,윤세현,천재성,이상민,이수민,이용직,이재수,이정수,이정훈,홍도성,김성종,연송하,이재균,차엽,서호철
라라랜드 : 엠마 스톤,라이언 고슬링,핀 위트록,J.K. 시몬스,로즈마리 드윗
미녀와 야수 : 자셋 데이,장 마레,밀라 파렐리
슈퍼배드 3 : 스티브 카렐,크리스틴 위그,트레이 파커
밀정 : 송강호,공유,한지민,츠루미 신고,엄태구,신성록,서영주,박민우,이진한,이진한,임서영,임서영,전수빈,정유안,조권수,조윤담,이동진,이상희,이수광,이승진,하민,노준표,김정우,김태준,고준,오하늬,원진아,전여빈
모아나 : 드웨인 존슨,아우이 크라발호,알란 터딕,제메인 클레멘트,테무에라 모리슨
보스 베이비 : 알렉 볼드윈,리사 쿠드로,스티브 부세미,토비 맥과이어,지미 키멜
킹스맨: 골든 서클 : 콜린 퍼스,줄리안 무어,태런 에저튼,마크 스트롱,할리 베리,엘튼 존,채닝 테이텀,제프 브리지스
인턴 : 앤 해서웨이,로버트 드니로,르네 루소,냇 울프,아담 드바인,앤드류 라넬스
내부자들 : 이병헌,조승우,백윤식,이경영,김홍파,배성우,조재윤,김대명,조우진,이엘,정만식,김병옥,김의성,박진우,남일우,김연지,김진우,문소리,박경순,설우신,손혜진,신정미,윤보배,이선관,이재남,이재정,이주아,신지수,장현준,최정연,황준혁,손종학,조덕제,유재명,조경현
조작된 도시 : 지창욱,심은경,안재홍,오정세,김상호,김민교,김기천,이하늬,박재민,박정환,박주현,박준규,박지홍,장민준,전영욱,정근수,정상문,신동호,신민철,정이삭,오준표,오지홍,조진규,윤성민,최경미,최경식,최창국,이민호,이민호,이상진,이석,이석,이수빈,한성관,이유진,이정훈,이정훈,이종혁,노남석,백승철,손강국,한지은
내부자들: 디 오리지널 : 신지수,이병헌,조승우,백윤식,이경영,김홍파,배성우,조재윤,김대명,조우진,이엘,정만식,김병옥,박진우,남일우,김의성,손종학,조덕제,유재명
봉이 김선달 : 유승호,조재현,고창석,라미란,시우민,연우진,전석호,서예지,주영호,박예슬,박상현,박진성,유일한,이선희,이규형
어벤져스: 에이지 오브 울트론 : 로버트 다우니 주니어,크리스 헴스워스,마크 러팔로,크리스 에반스,스칼렛 요한슨,제레미 레너,돈 치들,애런 존슨,엘리자베스 올슨,폴 베타니,코비 스멀더스,제임스 스페이더,사무엘 L. 잭슨,수현
애나벨 : 인형의 주인 : 스테파니 시그만,알리시아 벨라 베일리,미란다 오토,탈리타 베이트먼
더 킹 : 조인성,정우성,배성우,김아중,류준열,김의성,김민재,정성모,정은채,김소진,황승언,이주연,정준용,박시영,임승묵,박정민,박지홍,박진영,장승연,손영진,안용우,유현종,이나경,이석호,한미진,이승민,이윤희,김원진,김규선,남명렬,이가경,차지원,차엽,오대환,이세랑
덩케르크 : 톰 하디,마크 라이런스,케네스 브래너,킬리언 머피,제임스 다시,케빈 구스리
검은 사제들 : 김윤석,강동원,박소담,김병옥,김의성,이호재,남일우,김동현,김미영,김수진,김혜민,박지수,송선찬,이상민,이승훈,이현우,손종학,조수향,남문철
탐정 : 더 비기닝 : 권상우,성동일,박해준,이승준,조복래,오정세,박준면,이일화,서영희,강민지,홍서현,천유나,차승연,정종훈,정승연,이현기,이찬희,김승배,김은지,김태훈,김하늘,김희영,모일영,박민철,박성일,박시영,박지혜,최성원,홍은택,이해영,지대한,진용욱
덕혜옹주 : 손예진,박해일,윤제문,라미란,정상훈,박수영,김소현,박주미,안내상,김재욱,김인우,백윤식,김대명,김정희,박윤식,박지수,박혜영,송민수,송창현,신동주,오세영,이경훈,이명규,이상진,이승진,최영빈,최일순,최정순,한동훈,함성원,홍은지,김무규,김기정,차지원
신과함께-죄와 벌 : 하정우,차태현,주지훈,김향기,마동석,김동욱,도경수,오달수,임원희,장광,정해균,김수안,이정재,김해숙,이경영,김하늘,최용훈,강소백,정수윤,이수봉,이승준,이지향,김태준,정지훈,예수정,김기태,성유빈,오희준,이준혁
신비한 동물사전 : 에디 레드메인,콜린 파렐,캐서린 워터스턴,앨리슨 수돌,댄 포글러,사만다 모튼,젠 머레이
분노의 질주: 더 세븐 : 빈 디젤,폴 워커,드웨인 존슨,제이슨 스타뎀
겟 아웃 : 다니엘 칼루야,앨리슨 윌리암스,브래들리 휘트포드,캐서린 키너
조선명탐정 : 사라진 놉의 딸 : 김명민,오달수,이연희,강다현,전건익,정명철,박지선,배영민,정혜은,조관우,조명행,최지명,송병철,김나현,이경용,이귀현,이낙준,한대룡,이선도,이성동,이용우,김태환,정원중,남윤나,류광일,류현상,최무성,김원해,우현,황정민,이정은
